"a" = (/turf,/area)
"b" = (/turf,/turf/wall,/area)

(1,1,1) = {"
aaaaaaaaaaaaaaaaaaaaaaaaaaaaaaaa
aaaaaaaaaaaaaaaaaaaaaaaaaaaaaaaa
aaaaaaaaaaaaaaaaaaaaaaaaaaaaaaaa
aaaaaabaaaaaaaaaaabaaaaaaaaaaaaa
aaaaaabaaaaaaaaaaabaaaaaaaaaaaaa
aaaababbaaaaaaaaaabbaaaaaaaaaaaa
aaabbaabaaabbaaaaaaaaaaaaaaaaaaa
aaaabaaaaaaababaaaaaaaaaaaaaaaaa
aaaaaaaaaaaabaaaabbbbaaaaaaaaaaa
aaaaaaaaaaaabaaaaaaabbbbbaaaaaaa
aaaaaaaaaaaabaaaaaaaaaaaaaaaaaaa
aaaabaaaaaaabaaaaaaaaaaaaaaaaaaa
aaaabaaaaaabbaaaaaaaaabbaaaaaaaa
aaaabbaaaabbaaaaaaaabbbbbbaaaaaa
aaaaabbbbbbaaaaaaaabbaaaabbaaaaa
aabaaaaaaaaaaaaaaaabaaaaaaabaaaa
abaaaaaaaaaaaaaaaaabaaaaaaabbaaa
aaaaaaaaaaaaaaaaaaabaaaaaaaabaaa
aaaaaaaaaaaaaaaaaaabaaaaaaaabbaa
aaabaabbbbaaaaaaaaabaaaaaaaaabaa
aabababbbbaaaaaaaaabbaaaaaaaabaa
aaabaaaaaaaaaaaaaaaabaaaaaaaabaa
aaaaaaaaaaaaaaaaaaaabaaaaaaaabaa
aaaaaaaaaaaaaaaaaaabbaaaaaaaaaaa
aaaaabbaaaaaaaaaaaabaaaaaaaaaaaa
aaaaaaabaaaaaaaaaaabaaaaaaaaaaaa
aaaabaaaaaaaaaaaaaabaaaaaaaaaaaa
aaaaabbaaaaaaaaaaabbaaaaaaaaaaaa
aaaaaaaaaaaaaaaaabbaaaaaaaaaaaaa
aaaaaaaaaaaaabbbbbaaaaaaaaaaaaaa
aaaaaaaaaaaaaaaaaaaaaaaaaaaaaaaa
aaaaaaaaaaaaaaaaaaaaaaaaaaaaaaaa
"}
